# Nouns

de Aazug : suit [DE: anzug]

d Eitelkeit : vanity

d Täg	: (the) day
de Mäntig : (the) Monday
de Zieschtig : (the) Tuesday
de Mittwuch : (the) Wednesday
de Dunschtig : (the) Thursday
de Friitig : (the) Friday
de Samschtig : (the) Saturday
de Sunntig : (the) Sunday
am Sunntig : on Sunday

de Monät : the month
d Monäteö : the months
de Januar : (the) January
de Februar : (the) February
de März : (the) March
de April : (the) April
de Mai : (the) May
de Juni : (the) June
de Juli : (the) July
de Auguscht : (the) August
de Septämber : (the) September
de Oktober : (the) October
de Novämber : (the) November
de Dezämber : (the) December
im Dezember : in December

d Jahreszit : the season (of the year)
d Jahrzite : the seasons (of the year)
de Summer : (the) summer
de Herbscht : (the) fall
de Winter : (the) winter
de Früehlig : (the) spring
im Frühlig : in spring

de See : the lake
s Meer : the ocean

de Töff : the motorcycle 
