# Verbs (and verb phrases)
# Alphabetize by root verb
# Include infinitive, 4 present forms, and past participle with helper verb, ideally

# A

ässe : to eat
ich isse: I eat
ich ässe: I eat
du issisch : you eat
er isst: he eats
ich ha gässe : I ate

abstimme : to vote (on a referendum, yes or no)

# B

bruuche : to need, to use
Ich ha bruucht : I needed ["pruucht" also works]

bringe : to bring
ich ha bracht : I brought

# C

cho : to come [also "choo"]
ich chome : I come
du chunsch : you come
er chunt : he comes
mir chömed : we come
ich bi cho : I came [also "choo"]

mitbecho : to learn about [also "übercho"]

übercho : to receive

chöne : to be able to
ich cha(n) : I am able to (I can)
du chasch : you are able to  (you can)
sie cha(n) : she is able to (she can)
mir chönd : we are able to (we can)
ich ha chöne : I was able to (I could)

# D

dörfe : to be allowed to
Ich dörf : I am allowed to (I may)
du dörfsch : you are allowed to (you may)
sie dörf : she is allowed to (she may)
mir dörfed : we are allowed to (me may)

# E

# F

usefinde : to find out

# G

gaa : to go
ich gang : I go (variation ending in consonant)
ich gaa : I go (variation ending in vowel)
du gahsch : you go
er gaht : he goes
mir göhnd : we go
ich bin gange : I went

gsee : to see
ich gsee : I see
du gseesch : you see
er gseet : he sees
mir gsend : we see
ich ha gsee : I saw

uusgsee : to look like


gäh : to give
ich gib : I give
du gisch : you give
sie git : she gives
mir gäbed : we give

# H

haa : to have
ich ha(n) : I have
du häsch : you have
er hät : he has
mir händ : we have
ich ha gha : I had


haisse : to be called
ich haisse : I am called
du haissisch : you are called
er haisst : he is called
mir haissed : we are called

# I

# J

# K

# L

läse : to read
du lissisch : you read

legge : to (actively) lay (something) down
ich legge : I lay (something down)
du laisch : you lay (something down)
er lait : he lays (something down)
mir legged : we lay (something down)
gleit : laid (actively down)

aalegge : to put on (clothes)

zuälose : to (actively) listen to [as opposed to just hear something]

zuäluäge: to (actively) watch

labere : to speak, to talk (blah blah)

alüte : to call (on the phone) [DE anrufen] [w/ dative]

# M

mache : to make
ich ha gmacht : made

aamache : to turn on
abmache : to plan [to make plans]
uusmache : to turn off
ufmache : to open
vormache : to plan [to have plans already]
zumache : to close


möge : to like
ich mag : I like
du magsch : you like
er mag : he likes
mir möget : we like

möge : would like to
ich möcht : I would like to
du möchtisch : you would like to
er möcht : he would like to
mir möchted : we would like to

müesse : to have to
ich muess : I have to
du muesch : you have to
sie muess : she has to
mir müend : we have to
müemmer : we have to [inversion]

# N

ich nää : I take
du nimmsch: you take
er nimmt: he takes
mir nämed: we take

teilnäh : to take part [DE: teilnehmen]

# O

# P

# Q

# R

räne : to run

rede : to speak (to talk)

# S

säge : to say
ich säge : I say
du saisch : you say
er sait :  he says
mir säged : we say

schtaa : to stand
ich schtaa : I stand
du schtaasch : you stand
er schtaat : he stands
mir schtönd : we stand

ufschtaa : to stand up, to get up

schmöcke : to smell, to taste [no "riechen"!] 

schaffe : to work
ich schaffe : I work

staa : to stand
du staasch : you stand
er staat : he stands
mir stöhnd : we stand

verstaa : to understand

sii : to be
ich bi : I am
du bisch : you are
sie isch : she is
mir sind : we are
ich bi gsii : I was

sölle : should [infinitive]
ich söll : I should
du söllsch : you should
er söll : he should
mir sölled : we should

# T

träffe : to meet
ich träffe : I meet
du triffsch : you meet
er trifft: he meets
mir träffed : we meet
troffe : met

aaträffe : to meet (spontaneously)

# U

# V

# W

welle : to want
ich will: I want [or ich wett]
ich wett : I want [or Ich will]
du willsch: you want [or du wettsch]
du wettsch : you want [or du willsch]
er will: he wants [or er wett]
er wett: he wants [or er will]
mer wänd : we want

wone : to live (inhabit)
ich wone : I live (inhabit)
du wonsch : you live (inhabit)
er wont : he lives (inhabits)
sie wont : she lives (inhabits)
mir woned : we live (inhabit)

wählen : to vote (for a person, to choose someone)

# X

# Y

# Z

ziä : to pull [ziehen]
ich ziä : I pull
du ziäsch : you pull
er ziät : he pulls
mir ziänd : we pull
zoge : pulled

abziä : to take off (clothes)
